####################
#R   # IIIIII #   B#
# ## # ###### # ####
#    #      #      #
#I#### #### ########
#I   #    # #G     #
#I## #### # ###### #
# #   #   #   ##   #	
#   #   #   #    # #
####################
