####################
#R   #        #   B#
# ## # ###### # ####
#    #      # #    #
###### #### # ######
#    #    # #      #
# ## #### # ###### #
#    #      #     G#
####################
