####################
#R   #        #   B#
# ## # ##VV## # ####
#    #      #      #
# #### #### ########
#    #    # #      #
#OVVO####O#O###### #
#                  #	
#                 G#
####################
