####################
#R   #        #   B#
# ## # ###### # ####
#    #      #      #
# #### #### ########
#    #    # #      #
# ## #### # ###### #
#                 G#
####################
