####################
#R   #        #   B#
# ## # ###### # ####
#    #      #      #
# #### #### ########
#    #    # #G     #
# ## #### # ###### #
# #   #   #   ##   #	
#   #   #   #    # #
####################
