########################
#   IIIIIII#IIII#G#   R#
# ##IIIIIII#IIIIII#   ##
# #IIIIIIIIIII#III#OOO##
# #IIIIIIII#IIIIII#   ##
# ################## ###
# #                    #
# # VVVVVVVVVVVVV ## ###
#   IIIIIIIIIIIIII#   ##
#VV#IIVIII#IIIIII #OOO##
#  #IIIIIIIIIIIII #   ##
#                ##   B#    
########################
