####################
# R              B #
# ##VVVV# #VVVV#####
#       # #        #
######### ##########
#                  #
#    #VVV######### #
#    #             #
#    ###############  
#	          G#
####################
