####################
# R   ####   #     #
#        # # # # # #
# B   ##   #   # # #
################ # #
#                  #
# #VVVVVVVVVVVVVVV #
# #                #
# ##################  
#                G #
####################
