####################
#R   #        #   B#
#### # # ## # # ####
#      #    #      #
# ##O### ## ###O## #
# ## #        # ## #
# ##O# ##  ## #O## #
# ## #        # ## #	
#    #       G#    #
####################
