####################
#R       O        B#
#        O         #
#        O         #
#        O         #
#OOOOOOOOOOOOOOOOOO#
#                  #
#                  #	
#########O##########
#                  #
#                  #
#        G         #
####################
