#####################
#R#B#               #
# O # #VVVVV# #VVVVV#
# # # #     # #     #
# # # ##OOO## ###OOO#
# # # #     # #     #
# # # #     # #     #
# # # ####V## #V#####
#   # #     # #     #	
# # # #V##### #####V#
# # # #             #
#   O  ######V#######
# # # #G            #
############# #######
             #