#######################
#R#   #               # 
# ##### ############# #
#       ##   ######## #
#  ######  O          #
#  #      OGO ##VVVVVV#
#  # VVV#  O  #       #
#  #    ##   ## #VV# ##
#  #VV#   ###   #  # ##
#     ###     ##     B#
#######################
