#######################
#R#   #               # 
# ##### ############# #
#       ##   ######## #
#  ######  O          #
#  ##     OGO ##VVVVVV#
#  ## ###  O  #       #
#  ##   ##   ## #VV# ##
#  ##V#   ###   #  # ##
#     ###     ##     B#
#######################
