########################
#      #               #    
#### # # #VVVVVVVVVVV# # 
#    # #             # #
#OO  # #  ############ #
#BO  # #O    O######## #
#### #  O OOOG         #
#RO  # #O    O######## #
#OO  # #  ####       # #
#    # #             # #
####V# # VVVVVVVVVV# # #
#      #           #   #
########################
