########################
#B ##IIIIIIIIIIIIIIIIII#
#  #IIIIIIIIIIIIIIIIII##
##IIIIIIIIIIIIIIIIIIIII#
#IIIIIIIIIIIIIIIIIIIIII#
#IIIIIIIIIIIIIIIIIIIII##
#IIIIIIIIIIIIIIIIIIII G#
#IIIIIIIIIIIIIIIIIIIII##
#IIIIIIIIIIIIIIIIIIIIII#
##IIIIIIIIIIIIIIIIIIIII#
#  #IIIIIIIIIIIIIIIIIII#
#R #IIIIIIIIIIIIIIIIIII#    
########################
