########################
#   IIIIIII#IIII#G# B R#
# ##IIIIIII#IIIIII#    #
# #IIIIIIIIIII#III##OOO#
# #IIIIIIII#IIIIII##   #
# ##################V V#
# #                    #
# # VVVVVVVVVVVVV # VVV#
#   IIIIIIIIIIIIII#    #
#VV#IIVIII#IIIIII ######
#  #IIIIIIIIIIIII #   ##
#                ##   ##    
########################
