########################
#B ##IIIIIIIIIIIIIIIIII#
#  #IIIIIIIIIIIIIIIIII##
## IIIIIIIIIIIIIIIIIIII#
#IIIIIIIIIIIIIIIIIIIIII#
#IIIIIIIIIIIIIIIIIIIII##
#IIIIIIIIIIIIIIIIIIII G#
#IIIIIIIIIIIIIIIIIIIII##
#IIIIIIIIIIIIIIIIIIIIII#
## IIIIIIIIIIIIIIIIIIII#
#  #IIIIIIIIIIIIIIIIIII#
#R #IIIIIIIIIIIIIIIIIII#    
########################
